9 8
########
#E.....#
#.####.#
#....#.#
#.##.#.#
#..#.#.#
####.###
#.....T#
########
